***********************************************************
* '''''''''''''''''''''''' ***** '''''''''''''''''''''''' *
* ' ******** ' ********* ' ***** ' ********* ' ******** ' *
* ' ******** ' ********* ' ***** ' ********* ' ******** ' *
* ' ******** ' ********* ' ***** ' ********* ' ******** ' *
* H'''''''''''''''''''''''''''''''''''''''''''''''''''''H *
* ' ******** ' ***** ' ************* ' ***** ' ******** ' *
* ' ******** ' ***** ' ************* ' ***** ' ******** ' *
* ' ******** ' ***** ' ************* ' ***** ' ******** ' *
* '''''''''''' ***** ''''' ***** ''''' ***** '''''''''''' *
************ ' ********* ' ***** ' ********* ' ************
************ ' ********* ' ***** ' ********* ' ************
************ ' ********* ' ***** ' ********* ' ************
* '''''''''''' ***** ''''''''''''''''' ***** '''''''''''' *
* ' ******** ' ***** ' ****     **** ' ***** ' ******** ' *
* ' ******** ' ***** ' *     .     * ' ***** ' ******** ' *
* ' ******** ' ***** ' *     .     * ' ***** ' ******** ' *
* ' ******** ''''''''' *     .     * ''''''''' ******** ' *
* ' ******** ' ***** ' *           * ' ***** ' ******** ' *
* ' ******** ' ***** ' *           * ' ***** ' ******** ' *
* ' ******** ' ***** ' ************* ' ***** ' ******** ' *
* '''''''''''' ***** ''''''''''''''''' ***** '''''''''''' *
************ ' ********* ' ***** ' ********* ' ************
************ ' ********* ' ***** ' ********* ' ************
************ ' ********* ' ***** ' ********* ' ************
* '''''''''''' ***** ''''' ***** ''''' ***** '''''''''''' *
* ' ******** ' ***** ' ************* ' ***** ' ******** ' *
* ' ******** ' ***** ' ************* ' ***** ' ******** ' *
* ' ******** ' ***** ' ************* ' ***** ' ******** ' *
* H'''''''''''''''''''''''''''''''''''''''''''''''''''''H *
* ' ******** ' ********* ' ***** ' ********* ' ******** ' *
* ' ******** ' ********* ' ***** ' ********* ' ******** ' *
* ' ******** ' ********* ' ***** ' ********* ' ******** ' *
* ''''''''''''''''''''''''''''''''''''''''''''''''''''''' *
***********************************************************